1111111111111111111111
10ECCCC000000000000001
1000000000000000000001
1000000000000000000001
1010000000000000000001
1000000000000000000001
1000111000000000000001
1000000000000000000001
1000000000000000000001
1000000000000000000001
1001110000000000000001
1000000000000000000001
1000CC0000000000000001
10C000P000000000000001
1111111111111111111111